"kommunenummer","KomNavn","pop2000","pop2022","pop2034","pop2050","pop_change_2000_2022","pop_change_2022_2034","pop_change_2022_2050","km2_2000","km2_2022","km2_2034","km2_2050","km2_change_2000_2022","km2_change_2022_2034","km2_change_2022_2050"
5514,"Ibestad",1763,1289,1346,1302,-474,57,13,0.287765217391303,0.329086956521738,0.351626086956522,0.381678260869565,0.041321739130435,0.0225391304347839,0.052591304347827
3424,"Rendalen",2257,1722,1999,2055,-535,277,333,1.03904999999999,1.19193260869565,1.27532312252965,1.3865104743083,0.15288260869566,0.0833905138339999,0.19457786561265
3120,"Rakkestad",7076,8312,8846,9392,1236,534,1080,4.02363586956517,5.8870858695652,6.9035131422925,8.25874950592886,1.86345000000003,1.0164272727273,2.37166363636366
3207,"Nordre Follo",48347,61032,68704,73983,12685,7672,12951,10.8179217391304,14.7379304347826,16.8761169960474,19.7270324110672,3.9200086956522,2.1381865612648,4.9891019762846
5047,"Overhalla",3659,3817,4085,4098,158,268,281,0.697010869565217,0.726632608695652,0.742789920948617,0.764333003952569,0.0296217391304351,0.0161573122529649,0.0377003952569169
3438,"Sør-Fron",3322,3064,3108,3137,-258,44,73,0.7733152173913,1.04883260869565,1.19911482213439,1.39949110671937,0.27551739130435,0.15028221343874,0.35065849802372
3420,"Elverum",18046,21435,22212,22590,3389,777,1155,4.88112065217388,6.74601847826085,7.76323547430831,9.11952480237155,1.86489782608697,1.01721699604746,2.3735063241107
1560,"Tingvoll",3148,2960,3118,3158,-188,158,198,0.665285869565216,0.720948913043477,0.75131057312253,0.791792786561265,0.055663043478261,0.0303616600790531,0.070843873517788
3103,"Moss",39921,50290,56130,60744,10369,5840,10454,15.2427423913042,20.1514402173913,22.8289117588933,26.3988738142292,4.9086978260871,2.677471541502,6.2474335968379
4651,"Stryn",6666,7207,7269,7205,541,62,-2,4.30434782608697,3.83157391304348,3.57369723320158,3.22986166007905,-0.47277391304349,-0.2578766798419,-0.60171225296443
4601,"Bergen",229496,286930,308491,321493,57434,21561,34563,54.657997826087,54.6917673913044,54.7101871541502,54.7347468379447,0.0337695652174048,0.0184197628457952,0.0429794466402953
1820,"Alstahaug",7440,7333,7513,7290,-107,180,-43,0.603645652173906,0.795423913043475,0.90003023715415,1.03950533596838,0.191778260869569,0.104606324110675,0.244081422924905
3422,"Åmot",4379,4195,4756,4856,-184,561,661,2.52753260869564,3.41442391304348,3.89818280632411,4.54319466403162,0.88689130434784,0.48375889328063,1.12877075098814
1806,"Narvik",21498,21530,20950,19973,32,-580,-1557,14.613495652174,13.6744434782609,13.162233201581,12.4792861660079,-0.939052173913101,-0.5122102766799,-1.195157312253
1120,"Klepp",13789,20163,22744,24766,6374,2581,4603,6.39739565217388,8.83467391304347,10.1640984189723,11.9366644268775,2.43727826086959,1.32942450592883,3.10199051383403
5028,"Melhus",13169,17123,18533,19615,3954,1410,2492,3.86285869565216,4.68502826086956,5.13348438735178,5.73142588932806,0.8221695652174,0.44845612648222,1.0463976284585
3447,"Søndre Land",6073,5535,5728,5933,-538,193,398,0.763698913043473,1.02957065217391,1.17459160079051,1.36795286561265,0.265871739130437,0.1450209486166,0.33838221343874
5056,"Hitra",4923,5156,5854,6356,233,698,1200,4.19387282608695,4.57126630434782,4.77711729249012,5.05158527667984,0.377393478260871,0.205850988142299,0.48031897233202
3234,"Lunner",8264,9144,9736,10220,880,592,1076,1.74689999999999,2.19517826086956,2.43969367588933,2.76571422924901,0.44827826086957,0.24451541501977,0.57053596837945
4640,"Sogndal",10362,12097,13216,13889,1735,1119,1792,4.13460978260871,3.90638152173913,3.78189337944664,3.61590918972332,-0.22822826086958,-0.12448814229249,-0.29047233201581
3320,"Flå",1102,1057,1255,1311,-45,198,254,0.622349999999997,0.741971739130433,0.807219960474308,0.894217588932807,0.119621739130436,0.065248221343875,0.152245849802374
1865,"Vågan",9229,9724,10263,10431,495,539,707,1.02970760869566,0.935579347826087,0.884236660079052,0.815779743083004,-0.094128260869573,-0.051342687747035,-0.119799604743083
5616,"Hasvik",1200,964,1104,1189,-236,140,225,0.218504347826088,0.155582608695653,0.121261660079052,0.0755003952569177,-0.062921739130435,-0.034320948616601,-0.0800822134387353
1859,"Flakstad",1575,1216,1317,1324,-359,101,108,0.176654347826086,0.21496304347826,0.235858695652174,0.263719565217391,0.038308695652174,0.020895652173914,0.048756521739131
3105,"Sarpsborg",47447,58182,63281,66973,10735,5099,8791,19.5413184782608,24.3910467391304,27.0363530632411,30.5634281620553,4.8497282608696,2.6453063241107,6.1723814229249
1525,"Stranda",4677,4467,4290,4298,-210,-177,-169,2.76265760869566,2.68774239130434,2.64687954545454,2.59239575098814,-0.0749152173913199,-0.0408628458498002,-0.0953466403162002
5534,"Karlsøy",2496,2179,2457,2541,-317,278,362,2.58467282608696,2.71718804347826,2.78946907114625,2.88584377470356,0.1325152173913,0.0722810276679904,0.1686557312253
3218,"Ås",13568,20780,25559,28182,7212,4779,7402,5.11935652173909,7.19170434782606,8.32207588932807,9.82923794466405,2.07234782608697,1.13037154150201,2.63753359683799
3411,"Ringsaker",31622,35073,36622,38036,3451,1549,2963,7.92873586956517,11.2290554347826,13.029229743083,15.4294621541501,3.30031956521743,1.8001743083004,4.2004067193675
4227,"Kvinesdal",5554,5883,6273,6174,329,390,291,1.62841304347825,2.15252608695652,2.43840592885375,2.81957905138339,0.52411304347827,0.28587984189723,0.66705296442687
3305,"Ringerike",27917,31011,33107,35080,3094,2096,4069,8.89770326086955,11.4786880434783,12.8864979249012,14.7635777667984,2.58098478260875,1.4078098814229,3.2848897233201
4611,"Etne",3917,4043,3942,3783,126,-101,-260,1.75573369565216,2.26742282608695,2.54652598814229,2.91866353754941,0.51168913043479,0.27910316205534,0.65124071146246
4211,"Gjerstad",2509,2427,2447,2423,-82,20,-4,0.703594565217379,1.10509239130434,1.32409120553359,1.61608962450592,0.401497826086961,0.21899881422925,0.51099723320158
4005,"Notodden",12272,13029,13570,13535,757,541,506,4.72163478260869,5.64495652173913,6.14858656126483,6.82009328063241,0.92332173913044,0.5036300395257,1.17513675889328
3428,"Alvdal",2417,2445,2487,2359,28,42,-86,1.39465760869565,1.37499456521739,1.3642692687747,1.34996887351779,-0.0196630434782599,-0.01072529644269,-0.0250256916996001
3417,"Grue",5442,4548,4553,4533,-894,5,-15,1.42747826086956,1.55582608695652,1.62583399209486,1.71917786561265,0.12834782608696,0.07000790513834,0.16335177865613
4618,"Ullensvang",12440,10881,10544,10070,-1559,-337,-811,20.2536586956522,22.9666108695651,24.4464029644268,26.4194590909091,2.7129521739129,1.4797920948617,3.452848221344
4220,"Bygland",1351,1134,1302,1341,-217,168,207,0.695230434782605,0.902308695652174,1.0152604743083,1.16586284584981,0.207078260869569,0.112951778656126,0.263554150197636
1860,"Vestvågøy",10750,11566,11759,11800,816,193,234,0.948785869565214,1.34809239130435,1.56589594861661,1.85630069169961,0.399306521739136,0.21780355731226,0.50820830039526
1848,"Steigen",2977,2591,2795,2877,-386,204,286,0.859206521739129,1.01428043478261,1.0988662055336,1.21164723320158,0.155073913043481,0.0845857707509901,0.19736679841897
4225,"Lyngdal",8594,10480,11234,11439,1886,754,959,3.45395543478259,4.91314891304347,5.70907262845852,6.77030424901188,1.45919347826088,0.79592371541505,1.85715533596841
4206,"Farsund",9630,9622,9804,9599,-8,182,-23,5.55960326086956,5.92752717391304,6.12821294466404,6.39579397233202,0.36792391304348,0.200685770751,0.46826679841898
4201,"Risør",7000,6735,6869,6904,-265,134,169,2.98016413043477,4.16387934782608,4.80954219367588,5.67042598814229,1.18371521739131,0.645662845849801,1.50654664031621
4014,"Kragerø",10656,10351,10287,10069,-305,-64,-282,3.63525652173905,6.21473478260864,7.6217229249012,9.4977071146245,2.57947826086959,1.40698814229256,3.28297233201586
4226,"Hægebostad",1621,1704,1742,1691,83,38,-13,0.457522826086951,0.654955434782607,0.762645948616602,0.906233300395258,0.197432608695656,0.107690513833995,0.251277865612651
1121,"Time",13317,19353,21558,23350,6036,2205,3997,4.5699163043478,6.18672717391303,7.06862401185773,8.24448646245061,1.61681086956523,0.8818968379447,2.05775928853758
4639,"Vik",2965,2560,2387,2170,-405,-173,-390,2.50004347826087,2.5395652173913,2.56112252964427,2.58986561264822,0.0395217391304303,0.0215573122529698,0.0503003952569196
1813,"Brønnøy",7433,7777,7690,7395,344,-87,-382,1.12704456521739,1.35687717391304,1.48224041501976,1.64939140316206,0.22983260869565,0.12536324110672,0.29251422924902
1815,"Vega",1414,1175,1210,1209,-239,35,34,0.0643010869565216,0.0725771739130434,0.0770914031620554,0.0831103754940712,0.00827608695652179,0.004514229249012,0.0105332015810278
5544,"Nordreisa - Ráisa - Raisi",4821,4746,4785,4642,-75,39,-104,1.28328260869565,1.22161304347826,1.18797509881423,1.14312450592885,-0.06166956521739,-0.03363794466403,-0.07848853754941
3124,"Aremark",1451,1315,1436,1515,-136,121,200,0.699133695652169,1.00750108695652,1.17570148221344,1.39996867588933,0.308367391304351,0.16820039525692,0.39246758893281
3216,"Vestby",11815,18699,21840,24377,6884,3141,5678,5.5866326086956,9.3929673913043,11.46915,14.2373934782609,3.8063347826087,2.0761826086957,4.8444260869566
1146,"Tysvær",8828,11283,12205,12722,2455,922,1439,5.14610217391296,7.46634130434779,8.73192628458501,10.4193729249012,2.32023913043483,1.26558498023722,2.95303162055341
3454,"Vang",1675,1587,1864,1976,-88,277,389,3.28203586956521,4.37657282608693,4.97359298418972,5.76961986166009,1.09453695652172,0.59702015810279,1.39304703557316
4647,"Sunnfjord",19052,22116,22658,22428,3064,542,312,6.14046521739131,6.29589130434782,6.38066916996047,6.49370632411067,0.15542608695651,0.0847778656126499,0.19781501976285
3431,"Dovre",2851,2498,2534,2462,-353,36,-36,3.7815652173913,4.15158260869565,4.35341027667984,4.6225138339921,0.37001739130435,0.20182766798419,0.47093122529645
5518,"Loabák - Lavangen",1052,970,910,851,-82,-60,-119,0.366838043478261,0.387361956521739,0.398556818181818,0.413483300395257,0.020523913043478,0.011194861660079,0.026121343873518
3909,"Larvik",42765,47777,50657,52651,5012,2880,4874,27.9095673913042,34.7237804347825,38.4406239130434,43.3964152173912,6.8142130434783,3.71684347826091,8.6726347826087
1124,"Sola",18915,27568,31401,33906,8653,3833,6338,9.90719021739119,13.483027173913,15.4334836956522,18.0340923913043,3.57583695652181,1.9504565217392,4.5510652173913
1122,"Gjesdal",8911,12131,13133,14007,3220,1002,1876,2.79030326086955,3.92346195652173,4.54154851778656,5.36566393280632,1.13315869565218,0.61808656126483,1.44220197628459
3114,"Våler (Østfold)",4059,5913,7284,8431,1854,1371,2518,1.6618206521739,3.11639673913044,3.90980187747035,4.96767539525691,1.45457608695654,0.79340513833991,1.85127865612647
5055,"Heim",5866,5884,6192,5893,18,308,9,2.10775108695653,2.02770978260869,1.98405088932806,1.92583903162055,-0.0800413043478398,-0.0436588932806301,-0.10187075098814
4613,"Bømlo",10739,12061,12145,11879,1322,84,-182,3.70849891304343,5.79847499999997,6.93846195652175,8.45844456521739,2.08997608695654,1.13998695652178,2.65996956521742
1547,"Aukra",2978,3518,4066,4398,540,548,880,0.953080434782578,2.0011108695652,2.5727638339921,3.33496778656127,1.04803043478262,0.5716529644269,1.33385691699607
3328,"Ål",4789,4650,5330,5242,-139,680,592,2.01405326086957,2.21109456521739,2.31857164031621,2.46187440711463,0.19704130434782,0.10747707509882,0.25077984189724
1838,"Gildeskål",2351,1894,2209,2304,-457,315,410,0.257722826086957,0.280790217391304,0.293372430830039,0.31014871541502,0.023067391304347,0.012582213438735,0.029358498023716
4621,"Voss",14770,15875,17193,17546,1105,1318,1671,7.39524130434782,7.85208913043477,8.10127885375495,8.43353181818182,0.45684782608695,0.24918972332018,0.58144268774705
3336,"Rollag",1492,1370,1446,1466,-122,76,96,0.421816304347826,0.440618478260869,0.450874209486166,0.464548517786561,0.018802173913043,0.010255731225297,0.023930039525692
1531,"Sula",7070,9547,10326,10981,2477,779,1434,1.4147804347826,1.84932391304348,2.0863476284585,2.40237924901186,0.43454347826088,0.23702371541502,0.55305533596838
1566,"Surnadal",6252,5849,5746,5358,-403,-103,-491,2.5312695652174,2.44604347826087,2.39955652173913,2.33757391304348,-0.08522608695653,-0.0464869565217398,-0.10846956521739
5532,"Balsfjord",5749,5576,5654,5655,-173,78,79,3.45457173913043,3.85992391304347,4.08102509881423,4.3758266798419,0.40535217391304,0.22110118577076,0.51590276679843
1828,"Nesna",1882,1698,2104,2235,-184,406,537,0.147326086956521,0.172447826086956,0.186150592885375,0.204420948616601,0.025121739130435,0.013702766798419,0.031973122529645
3430,"Os",2148,1855,1906,1876,-293,51,21,0.555123913043479,0.462423913043478,0.411860276679843,0.344442094861662,-0.0927000000000009,-0.050563636363635,-0.117981818181816
4214,"Froland",4497,6098,6846,7459,1601,748,1361,1.21667282608692,2.88810978260869,3.79980266798419,5.01539318181818,1.67143695652177,0.9116928853755,2.12728339920949
1119,"Hå",13921,19296,20614,21551,5375,1318,2255,8.70734347826084,11.2692130434782,12.6665964426877,14.5297743083004,2.56186956521736,1.3973833992095,3.2605612648222
4028,"Kviteseid",2667,2452,2505,2513,-215,53,61,0.909332608695635,1.5803804347826,1.94640652173913,2.43444130434782,0.671047826086965,0.36602608695653,0.85406086956522
4631,"Alver",22430,29593,30727,31835,7163,1134,2242,9.72003913043471,13.0439347826087,14.8569687747036,17.27434743083,3.32389565217399,1.8130339920949,4.2304126482213
5618,"Måsøy",1477,1162,1239,1334,-315,77,172,0.485315217391306,0.439336956521739,0.41425790513834,0.380819169960474,-0.045978260869567,-0.025079051383399,-0.058517786561265
3901,"Horten",23764,27502,28740,29859,3738,1238,2357,8.61823369565212,10.3594010869565,11.3091287549407,12.5754323122529,1.74116739130438,0.949727667984199,2.2160312252964
1563,"Sunndal",7368,6932,7219,6812,-436,287,-120,8.52389021739132,8.44666630434782,8.40454416996047,8.34838132411067,-0.0772239130435004,-0.0421221343873501,-0.0982849802371497
3226,"Aurskog-Høland",13235,17754,19010,20818,4519,1256,3064,5.55333260869565,7.40533695652175,8.41552114624505,9.76243339920948,1.8520043478261,1.0101841897233,2.35709644268773
3903,"Holmestrand",19652,25681,30218,33427,6029,4537,7746,11.2231858695652,13.2974315217391,14.4288382411067,15.9373805335968,2.0742456521739,1.1314067193676,2.6399490118577
4022,"Seljord",2928,2889,2963,2930,-39,74,41,1.18919347826085,1.57951956521739,1.79242470355732,2.07629822134387,0.39032608695654,0.21290513833993,0.49677865612648
4636,"Solund",959,768,760,778,-191,-8,10,0.442780434782609,0.421454347826087,0.409821936758893,0.394312055335968,-0.021326086956522,-0.011632411067194,-0.027142292490119
5052,"Leka",714,570,678,704,-144,108,134,0.0419282608695651,0.0478369565217391,0.0510598814229249,0.0553571146245059,0.005908695652174,0.00322292490118579,0.00752015810276679
3330,"Hol",4642,4504,4734,4891,-138,230,387,3.39438913043478,3.73314130434781,3.91791521739131,4.1642804347826,0.33875217391303,0.1847739130435,0.43113913043479
3412,"Løten",7188,7715,8311,8558,527,596,843,1.21587065217389,1.86447717391304,2.21826254940712,2.6899763833992,0.64860652173915,0.35378537549408,0.82549920948616
5612,"Guovdageaidnu - Kautokeino",3068,2877,2710,2550,-191,-167,-327,1.61693804347827,1.29538369565218,1.11999041501976,0.88613270750988,-0.32155434782609,-0.17539328063242,-0.4092509881423
1816,"Vevelstad",592,462,531,534,-130,69,72,0.347341304347831,0.269354347826087,0.226816007905138,0.170098221343873,-0.077986956521744,-0.042538339920949,-0.099256126482214
1135,"Sauda",5081,4525,4397,4162,-556,-128,-363,1.63714891304348,1.73816413043478,1.79326333992095,1.86672895256917,0.1010152173913,0.0550992094861702,0.12856482213439
5060,"Nærøysund",9220,9732,9998,9876,512,266,144,1.80388369565216,2.55015978260869,2.95721946640316,3.49996571146244,0.74627608695653,0.40705968379447,0.94980592885375
4003,"Skien",49592,55513,58972,60551,5921,3459,5038,15.0350576086955,19.543177173913,22.0021514822134,25.2807838932806,4.5081195652175,2.4589743083004,5.7376067193676
3414,"Nord-Odal",5089,5016,4858,4824,-73,-158,-192,0.776924999999991,1.10407499999999,1.28252045454546,1.52044772727273,0.327149999999999,0.17844545454547,0.41637272727274
5045,"Grong",2565,2287,2438,2466,-278,151,179,0.580196739130436,0.490177173913043,0.441075592885376,0.375606818181819,-0.090019565217393,-0.049101581027667,-0.114570355731224
4223,"Vennesla",12141,15123,16371,17307,2982,1248,2184,3.33943043478257,4.79445652173911,5.5881071146245,6.64630790513832,1.45502608695654,0.79365059288539,1.85185138339921
3222,"Lørenskog",29505,44693,56641,63803,15188,11948,19110,6.9193663043478,8.31630326086956,9.0782688735178,10.0942230237154,1.39693695652176,0.76196561264824,1.77791976284584
1866,"Hadsel",8321,8107,8252,8057,-214,145,-50,0.694418478260866,0.813903260869562,0.879076778656126,0.96597480237154,0.119484782608696,0.065173517786564,0.152071541501978
1133,"Hjelmeland",2756,2534,2689,2680,-222,155,146,1.20447391304348,1.44520434782608,1.57651185770751,1.7515885375494,0.2407304347826,0.13130750988143,0.30638418972332
5021,"Oppdal",6288,7066,7551,7501,778,485,435,4.51758913043479,4.65074999999999,4.72338320158103,4.82022747035573,0.1331608695652,0.0726332015810405,0.169477470355741
5526,"Sørreisa",3294,3414,3531,3422,120,117,8,0.546622826086955,0.668064130434782,0.734304841897234,0.822625790513834,0.121441304347827,0.066240711462452,0.154561660079052
5025,"Røros - Rossen",5545,5572,5945,6018,27,373,446,1.87895543478261,1.74381847826087,1.67010741106719,1.57182598814229,-0.13513695652174,-0.07371106719368,-0.17199249011858
3214,"Frogn",12972,16084,16930,18101,3112,846,2017,3.6796304347826,4.79242173913043,5.39939881422926,6.20870158102766,1.11279130434783,0.60697707509883,1.41627984189723
4650,"Gloppen",5769,5875,5857,5715,106,-18,-160,3.6569641304348,3.227175,2.99274456521739,2.68017065217391,-0.4297891304348,-0.23443043478261,-0.54700434782609
1514,"Sande",3081,2422,2401,2375,-659,-21,-47,0.777453260869567,0.69666847826087,0.6526040513834,0.593851482213439,-0.080784782608697,-0.0440644268774699,-0.102816996047431
4642,"Lærdal",2202,2117,2188,2152,-85,71,35,5.16885652173913,6.04420434782607,6.52166679841897,7.15828339920948,0.87534782608694,0.4774624505929,1.11407905138341
1505,"Kristiansund",22124,24013,24628,24346,1889,615,333,6.68374239130432,8.41997934782609,9.36701768774704,10.6297354743083,1.73623695652177,0.947038339920951,2.20975612648221
4221,"Valle",1439,1169,1213,1187,-270,44,18,1.12200652173913,1.25281956521739,1.32417213438735,1.41930889328063,0.13081304347826,0.0713525691699601,0.16648932806324
3449,"Sør-Aurdal",3389,2889,2710,2625,-500,-179,-264,0.814861956521739,0.819538043478261,0.822088636363636,0.82548942687747,0.004676086956522,0.00255059288537507,0.00595138339920898
3240,"Eidsvoll",17524,26716,31365,35067,9192,4649,8351,5.12444347826079,8.72037391304343,10.681790513834,13.2970126482213,3.59593043478264,1.96141660079057,4.57663873517787
4645,"Askvoll",3349,2951,2938,2788,-398,-13,-163,0.977057608695654,0.948472826086955,0.932881126482213,0.912092193675889,-0.0285847826086989,-0.015591699604742,-0.036380632411066
3322,"Nesbyen",3528,3273,3174,3050,-255,-99,-223,1.21608586956522,1.0687402173913,0.988369861660079,0.881209387351778,-0.14734565217392,-0.0803703557312211,-0.187530830039522
1106,"Haugesund",30362,37444,39919,41120,7082,2475,3676,10.3432597826087,10.9289054347826,11.2483485177866,11.6742726284585,0.5856456521739,0.319443083004,0.7453671936759
1576,"Aure",3823,3384,3378,3243,-439,-6,-141,1.96046413043479,1.85764891304348,1.80156788537549,1.72679318181818,-0.10281521739131,-0.0560810276679899,-0.1308557312253
3419,"Våler (Innlandet)",4063,3597,3557,3502,-466,-40,-95,1.70210543478261,1.81916413043478,1.88301432806324,1.96814792490119,0.11705869565217,0.06385019762846,0.14898379446641
1836,"Rødøy",1570,1153,1076,982,-417,-77,-171,0.661030434782621,0.400813043478262,0.258876284584979,0.0696272727272724,-0.260217391304359,-0.141936758893283,-0.33118577075099
4010,"Siljan",2269,2349,2506,2674,80,157,325,0.507824999999993,0.704983695652171,0.812524802371542,0.95591294466403,0.197158695652178,0.107541106719371,0.250929249011859
3415,"Sør-Odal",7349,7978,8570,9034,629,592,1056,2.05863260869562,3.47057608695651,4.2407270750988,5.26759505928853,1.41194347826089,0.77015098814229,1.79701897233202
1508,"Ålesund",45776,57690,60456,62151,11914,2766,4461,9.96990652173906,12.6762847826087,14.1524911067193,16.1207662055336,2.70637826086964,1.4762063241106,3.4444814229249
4617,"Kvinnherad",13196,13017,12515,11876,-179,-502,-1141,6.05640326086957,6.07810108695652,6.08993626482213,6.10571650197628,0.0216978260869505,0.0118351778656098,0.0276154150197598
1532,"Giske",6344,8597,9101,9747,2253,504,1150,1.56496304347824,2.36169782608694,2.79628043478261,3.37572391304349,0.7967347826087,0.43458260869567,1.01402608695655
4628,"Vaksdal",4192,3867,3736,3614,-325,-131,-253,1.21096956521739,1.23084782608696,1.24169051383399,1.25614743083004,0.01987826086957,0.01084268774703,0.02529960474308
3122,"Marker",3300,3578,3755,3988,278,177,410,1.85312934782608,2.87335760869566,3.42984575098814,4.17182994071146,1.02022826086958,0.55648814229248,1.2984723320158
5049,"Flatanger",1238,1101,1177,1210,-137,76,109,0.393006521739128,0.506836956521738,0.568926284584979,0.651712055335969,0.11383043478261,0.062089328063241,0.144875098814231
5053,"Inderøy",6727,6794,7254,7346,67,460,552,1.40800108695652,1.69793804347826,1.8560854743083,2.06694871541502,0.28993695652174,0.15814743083004,0.36901067193676
3434,"Lom",2567,2211,2090,1916,-356,-121,-295,10.2320510869566,10.5595141304347,10.7381303359684,10.9762852766798,0.327463043478099,0.1786162055337,0.4167711462451
5036,"Frosta",2430,2608,2739,2872,178,131,264,1.37229456521739,1.468575,1.52109160079052,1.59111373517787,0.0962804347826101,0.05251660079052,0.12253873517787
3401,"Kongsvinger",17349,17949,18285,18346,600,336,397,4.37052717391302,5.17440326086955,5.61288112648222,6.19751828063242,0.80387608695653,0.43847786561267,1.02311501976287
4630,"Osterøy",7006,8131,8223,8340,1125,92,209,1.53426521739131,1.5540652173913,1.5648652173913,1.5792652173913,0.01979999999999,0.0107999999999999,0.0251999999999999
5035,"Stjørdal",18238,24287,25363,26298,6049,1076,2011,7.58051413043476,8.6932858695652,9.30025227272727,10.1095408102767,1.11277173913044,0.606966403162071,1.4162549407115
1874,"Moskenes",1352,982,1030,1128,-370,48,146,0.181594565217391,0.211275,0.227464328063241,0.249050098814229,0.029680434782609,0.016189328063241,0.037775098814229
4034,"Tokke",2506,2140,2203,2171,-366,63,31,0.674227173913032,1.00728586956521,1.18895424901186,1.43117875494071,0.333058695652178,0.18166837944665,0.4238928853755
4602,"Kinn",17705,17131,17084,16489,-574,-47,-642,8.16133695652174,8.5526804347826,8.76614051383399,9.05075395256917,0.391343478260859,0.213460079051391,0.498073517786571
3426,"Tolga",1812,1551,1580,1477,-261,29,-74,0.570042391304349,0.488983695652173,0.444769861660079,0.385818083003952,-0.081058695652176,-0.044213833992094,-0.103165612648221
5057,"Ørland",9733,10371,10853,11228,638,482,857,5.65627499999997,7.89169891304346,9.11102104743083,10.7367838932806,2.23542391304349,1.21932213438737,2.84508498023714
3407,"Gjøvik",27013,30267,32370,33447,3254,2103,3180,6.44046847826086,7.09427934782609,7.45090345849802,7.92640227272727,0.65381086956523,0.35662411067193,0.83212292490118
4623,"Samnanger",2282,2501,2502,2523,219,1,22,0.882450000000002,0.812210869565217,0.77389861660079,0.722815612648222,-0.0702391304347849,-0.0383122529644271,-0.089395256916995
5601,"Alta",16837,21144,22671,23062,4307,1527,1918,6.56671304347823,7.96867826086957,8.73338656126481,9.75299762845849,1.40196521739134,0.76470830039524,1.78431936758892
1804,"Bodø",42465,52803,55351,56427,10338,2548,3624,5.1265760869565,5.75058913043478,6.09095988142292,6.54478754940711,0.62401304347828,0.34037075098814,0.79419841897233
3427,"Tynset",5473,5581,5754,5708,108,173,127,1.97015869565218,1.86313695652174,1.80476146245059,1.72692747035573,-0.10702173913044,-0.0583754940711498,-0.13620948616601
3318,"Krødsherad",2254,2189,2312,2334,-65,123,145,0.805783695652172,0.955320652173912,1.03688626482213,1.14564041501976,0.14953695652174,0.0815656126482179,0.190319762845848
1577,"Volda",9549,10809,12037,12551,1260,1228,1742,2.38606630434783,2.39935108695652,2.40659733201581,2.41625899209486,0.0132847826086899,0.00724624505929006,0.0169079051383401
3212,"Nesodden",15448,19939,21887,23653,4491,1948,3714,3.17995434782608,4.68041086956521,5.49884169960472,6.59008280632409,1.50045652173913,0.818430830039509,1.90967193675888
5524,"Målselv",7054,6599,7034,7087,-455,435,488,7.59271304347825,8.0457652173913,8.29288458498024,8.62237707509881,0.453052173913051,0.247119367588938,0.576611857707508
3334,"Flesberg",2491,2720,3056,3275,229,336,555,0.938641304347819,1.41223695652173,1.67056185770751,2.01499505928854,0.473595652173911,0.25832490118578,0.60275810276681
3224,"Rælingen",14493,19024,22962,25355,4531,3938,6331,2.37766304347824,3.42819782608696,4.00121679841897,4.76524209486166,1.05053478260872,0.57301897233201,1.3370442687747
3101,"Halden",26733,31444,33062,34707,4711,1618,3263,9.67871739130419,13.4594217391303,15.521624110672,18.2712272727273,3.78070434782611,2.0622023715417,4.811805533597
1144,"Kvitsøy",523,523,607,680,0,84,157,0.277248913043477,0.315264130434782,0.335999703557313,0.363647134387352,0.038015217391305,0.020735573122531,0.04838300395257
4036,"Vinje",3869,3755,3954,3962,-114,199,207,2.58826304347825,3.13010217391304,3.42565079051384,3.81971561264822,0.54183913043479,0.2955486166008,0.68961343873518
5610,"Kárásjohka - Karasjok",2901,2584,2469,2321,-317,-115,-263,1.99405760869565,2.13428152173912,2.21076729249012,2.3127483201581,0.14022391304347,0.0764857707509998,0.17846679841898
1835,"Træna",466,450,522,567,-16,72,117,0.0676663043478261,0.0824380434782608,0.0904953557312253,0.101238438735178,0.0147717391304347,0.00805731225296451,0.0188003952569172
1127,"Randaberg",8773,11454,12762,13892,2681,1308,2438,2.87862065217391,3.64403152173914,4.0615283596838,4.61819081027668,0.76541086956523,0.41749683794466,0.97415928853754
4625,"Austevoll",4406,5283,5226,5218,877,-57,-65,2.2601152173913,2.87379782608695,3.2085337944664,3.65484841897233,0.61368260869565,0.33473596837945,0.78105059288538
3201,"Bærum",101494,128982,137655,148099,27488,8673,19117,20.0334228260869,22.885229347826,24.4407601778656,26.514801284585,2.8518065217391,1.5555308300396,3.629571936759
3439,"Ringebu",4752,4385,4337,4221,-367,-48,-164,1.78708695652174,1.92498260869565,2.00019841897233,2.10048616600791,0.13789565217391,0.0752158102766798,0.17550355731226
1114,"Bjerkreim",2456,2789,3030,3026,333,241,237,0.992455434782599,1.5466402173913,1.84892282608696,2.25196630434783,0.554184782608701,0.30228260869566,0.70532608695653
5034,"Meråker",2637,2399,2557,2642,-238,158,243,0.714952173913046,0.616030434782608,0.562073122529644,0.490130039525692,-0.098921739130438,-0.053957312252964,-0.125900395256916
4026,"Tinn",6560,5512,5334,5157,-1048,-178,-355,1.28914239130434,1.62036195652174,1.80102717391304,2.04191413043478,0.3312195652174,0.1806652173913,0.42155217391304
5530,"Senja",15011,14738,14813,14579,-273,75,-159,3.6776054347826,4.24544673913043,4.5551783596838,4.96815385375494,0.56784130434783,0.30973162055337,0.72270711462451
1841,"Fauske - Fuossko",9632,9603,9980,9644,-29,377,41,3.39294130434783,3.43062391304348,3.45117806324111,3.47858359683794,0.0376826086956501,0.0205541501976301,0.0479596837944598
1867,"Bø",3288,2565,2675,2630,-723,110,65,0.144860869565216,0.206686956521738,0.240410276679842,0.285374703557313,0.061826086956522,0.033723320158104,0.078687747035575
4215,"Lillesand",8816,11279,12322,13372,2463,1043,2093,6.03415760869558,8.90067717391298,10.4642333003952,12.5489748023715,2.8665195652174,1.56355612648222,3.64829762845852
1520,"Ørsta",10276,10833,10755,10531,557,-78,-302,2.69430652173913,2.64425869565217,2.61695988142292,2.58056146245059,-0.0500478260869603,-0.0272988142292498,-0.0636972332015797
1851,"Lødingen",2471,1976,2223,2167,-495,247,191,0.818197826086955,0.912697826086955,0.964243280632412,1.03297055335968,0.0945,0.051545454545457,0.120272727272725
4629,"Modalen",354,378,403,412,24,25,34,1.44779673913043,1.5884902173913,1.66523211462451,1.76755464426877,0.14069347826087,0.0767418972332099,0.17906442687747
3451,"Nord-Aurdal",6560,6354,6690,6541,-206,336,187,1.82097391304347,2.20241739130434,2.41047747035574,2.68789090909092,0.38144347826087,0.2080600790514,0.48547351778658
1134,"Suldal",4043,3784,3837,3681,-259,53,-103,3.12330326086956,3.44207934782608,3.61595721343874,3.84779436758893,0.31877608695652,0.17387786561266,0.40571501976285
4646,"Fjaler",2964,2901,2927,3069,-63,26,168,0.619953260869561,0.829907608695649,0.944428162055335,1.09712223320158,0.209954347826088,0.114520553359686,0.267214624505931
3324,"Gol",4390,4667,5373,5535,277,706,868,1.78113913043478,1.86018260869565,1.90329723320158,1.96078339920949,0.0790434782608702,0.04311462450593,0.10060079051384
1825,"Grane",1652,1461,1440,1416,-191,-21,-45,1.04939021739132,0.717427173913045,0.536356422924904,0.294928754940713,-0.331963043478275,-0.181070750988141,-0.422498418972332
4627,"Askøy",19727,29816,31186,32853,10089,1370,3037,8.84904456521735,10.9995554347826,12.1725613636364,13.7365692687747,2.15051086956525,1.1730059288538,2.7370138339921
4222,"Bykle",868,935,1248,1425,67,313,490,1.86925108695652,2.11109673913043,2.24301254940712,2.41890029644269,0.24184565217391,0.13191581027669,0.30780355731226
4024,"Hjartdal",1687,1562,1697,1632,-125,135,70,0.491204347826084,0.606326086956521,0.669119762845849,0.75284466403162,0.115121739130437,0.0627936758893279,0.146518577075099
3310,"Hole",4977,6859,7764,8570,1882,905,1711,1.94319782608695,2.56580217391304,2.90540454545454,3.35820770750988,0.62260434782609,0.3396023715415,0.79240553359684
1580,"Haram",8774,9424,9474,9685,650,50,261,1.733175,2.0753902173913,2.26205306324111,2.51093685770751,0.3422152173913,0.18666284584981,0.43554664031621
4641,"Aurland",1833,1766,2077,2263,-67,311,497,8.0748489130435,9.23755108695649,9.87175227272727,10.7173538537549,1.16270217391299,0.634201185770781,1.47980276679841
3911,"Færder",24106,27165,28790,30052,3059,1625,2887,11.5757902173912,14.6914532608695,16.3909058300395,18.6568425889328,3.1156630434783,1.69945256917,3.9653893280633
4202,"Grimstad",17821,24017,27308,29383,6196,3291,5366,8.13378913043471,11.5265934782608,13.3772140316206,15.8447081027668,3.39280434782609,1.8506205533598,4.318114624506
1108,"Sandnes",54016,81305,88719,93609,27289,7414,12304,17.6954282608694,23.4466239130435,26.5836397233202,30.7663274703557,5.7511956521741,3.1370158102767,7.3197035573122
1506,"Molde",28977,32002,34045,34602,3025,2043,2600,8.38337282608696,8.84747934782608,9.10062835968379,9.43816037549407,0.46410652173912,0.25314901185771,0.590681027667989
1853,"Evenes - Evenássi",1523,1334,1439,1467,-189,105,133,1.74849456521739,1.87639239130435,1.94615484189723,2.03917144268775,0.12789782608696,0.06976245059288,0.1627790513834
1818,"Herøy (Nordland)",1881,1825,1952,1982,-56,127,157,0.212536956521735,0.359628260869563,0.439859881422925,0.546835375494072,0.147091304347828,0.080231620553362,0.187207114624509
5061,"Rindal",2138,1980,1794,1636,-158,-186,-344,0.671028260869569,0.574336956521739,0.521596245059289,0.451275296442689,-0.09669130434783,-0.05274071146245,-0.12306166007905
4218,"Iveland",1128,1323,1527,1639,195,204,316,0.207802173913034,0.518067391304342,0.687302964426877,0.912950395256916,0.310265217391308,0.169235573122535,0.394883003952574
5516,"Gratangen - Rivtták",1345,1070,1083,1125,-275,13,55,0.355382608695651,0.42346956521739,0.46060790513834,0.510125691699605,0.068086956521739,0.03713833992095,0.086656126482215
3437,"Sel",6273,5531,5778,5359,-742,247,-172,3.50954021739131,3.58605978260869,3.62779772727273,3.6834483201581,0.0765195652173798,0.0417379446640402,0.0973885375494099
3450,"Etnedal",1401,1256,1494,1452,-145,238,196,0.257791304347823,0.382617391304347,0.450704347826087,0.54148695652174,0.124826086956524,0.06808695652174,0.158869565217393
5001,"Trondheim - Tråante",153734,210496,233140,250341,56762,22644,39845,33.627629347826,37.6304576086956,39.8138184782609,42.7249663043479,4.0028282608696,2.1833608695653,5.0945086956523
4632,"Austrheim",2527,2889,3057,3240,362,168,351,1.03013804347825,1.4922097826087,1.74424891304348,2.08030108695652,0.46207173913045,0.25203913043478,0.58809130434782
3205,"Lillestrøm",60105,89095,104241,113461,28990,15146,24366,18.2799586956521,22.6816239130434,25.0825322134388,28.2837432806324,4.4016652173913,2.4009083003954,5.602119367589
1824,"Vefsn",13553,13233,13195,12752,-320,-38,-481,1.83662608695653,1.72166086956522,1.65895256916996,1.57534150197628,-0.11496521739131,-0.06270830039526,-0.14631936758894
1845,"Sørfold - Fuolldá",2367,1869,1839,1793,-498,-30,-76,9.46383260869565,9.9834456521739,10.2668709486166,10.6447713438735,0.51961304347825,0.283425296442699,0.6613256916996
1528,"Sykkylven",7280,7558,7266,6868,278,-292,-690,1.77047608695652,1.77309782608695,1.77452786561265,1.77643458498024,0.00262173913043018,0.00143003952569987,0.00333675889328999
4219,"Evje og Hornnes",3346,3653,4287,4368,307,634,715,1.60104130434781,2.1752804347826,2.48850177865613,2.90613023715415,0.57423913043479,0.31322134387353,0.73084980237155
5007,"Namsos - Nåavmesjenjaelmie",14950,15001,14808,14250,51,-193,-751,2.4984,2.71760869565217,2.83717707509881,2.99660158102767,0.21920869565217,0.11956837944664,0.2789928853755
1130,"Strand",10122,13268,14231,14711,3146,963,1443,3.99880760869561,5.38388804347824,6.13938646245056,7.14671768774702,1.38508043478263,0.755498418972319,1.76282964426878
1578,"Fjord",3012,2491,2495,2510,-521,4,19,4.57925869565219,4.37855869565217,4.26908596837945,4.12312233201581,-0.200700000000021,-0.10947272727272,-0.25543636363636
3301,"Drammen",81602,102273,109675,115964,20671,7402,13691,23.901779347826,26.5674032608695,28.0213799407115,29.960015513834,2.6656239130435,1.453976679842,3.3926122529645
3242,"Hurdal",2648,2905,3576,4000,257,671,1095,0.30387717391304,0.442183695652174,0.51762361660079,0.618210177865614,0.138306521739134,0.075439920948616,0.17602648221344
3303,"Kongsberg",22293,27879,30362,32165,5586,2483,4286,6.58522173913036,10.2011086956522,12.1734106719367,14.8031466403162,3.61588695652184,1.9723019762845,4.602037944664
5620,"Nordkapp",3517,2947,3005,2954,-570,58,7,1.20271304347826,1.20099130434783,1.20005217391304,1.1988,-0.00172173913043006,-0.000939130434789881,-0.00219130434782988
3116,"Skiptvet",3140,3846,4332,4740,706,486,894,1.42338913043476,2.18357608695651,2.59822351778656,3.15108675889328,0.76018695652175,0.41464743083005,0.96751067193677
5634,"Vardø",2705,1897,2119,2136,-808,222,239,0.557002173913044,0.633736956521738,0.675592292490119,0.731399407114624,0.076734782608694,0.041855335968381,0.097662450592886
4612,"Sveio",4623,5775,5907,6092,1152,132,317,1.24439673913042,2.13709891304347,2.6240273715415,3.27326531620553,0.89270217391305,0.48692845849803,1.13616640316206
5630,"Berlevåg",1236,906,925,926,-330,19,20,0.738851086956524,0.692148913043479,0.666675,0.632709782608695,-0.046702173913045,-0.025473913043479,-0.059439130434784
4030,"Nissedal",1447,1414,1544,1535,-33,130,121,0.750824999999992,1.48892282608696,1.8915216403162,2.42832005928854,0.738097826086968,0.40259881422924,0.93939723320158
3425,"Engerdal",1580,1253,1579,1578,-327,326,325,0.897202173913048,0.787128260869565,0.727087944664031,0.64703418972332,-0.110073913043483,-0.060040316205534,-0.140094071146245
4622,"Kvam",8592,8497,8129,7812,-95,-368,-685,2.81905434782609,2.75718913043478,2.72344446640316,2.67845158102767,-0.0618652173913099,-0.0337446640316204,-0.0787375494071103
1579,"Hustadvika",12198,13287,13499,13391,1089,212,104,3.50759347826085,4.1775456521739,4.54297411067193,5.03021205533596,0.66995217391305,0.36542845849803,0.85266640316206
1832,"Hemnes",4689,4420,4409,4237,-269,-11,-183,0.810626086956528,0.605660869565217,0.493861660079051,0.344796047430829,-0.204965217391311,-0.111799209486166,-0.260864822134388
4643,"Årdal",5797,5204,4936,4441,-593,-268,-763,5.20597173913045,5.04228913043477,4.95300770750988,4.83396581027668,-0.16368260869568,-0.0892814229248895,-0.20832332015809
5058,"Åfjord",4524,4252,4375,4269,-272,123,17,3.33264130434779,4.86252391304345,5.69700533596838,6.80964723320158,1.52988260869566,0.83448142292493,1.94712332015813
3228,"Nes",16288,23898,27320,30209,7610,3422,6311,4.53687065217389,6.34201630434782,7.32664120553358,8.63947440711461,1.80514565217393,0.98462490118576,2.29745810276679
4020,"Midt-Telemark",9375,10539,11944,12795,1164,1405,2256,3.39580760869562,4.68087065217389,5.38181413043476,6.3164054347826,1.28506304347827,0.700943478260871,1.63553478260871
5614,"Loppa",1426,859,1000,1094,-567,141,235,0.191416304347827,0.152540217391305,0.131335079051384,0.103061561264823,-0.038876086956522,-0.021205138339921,-0.049478656126482
3416,"Eidskog",6409,6032,6095,6129,-377,63,97,2.06685,2.21182826086957,2.29090731225297,2.39634604743083,0.14497826086957,0.0790790513833999,0.18451778656126
3403,"Hamar",26545,31999,35832,38063,5454,3833,6064,7.52110434782605,9.04914782608697,9.88262608695653,10.9939304347826,1.52804347826092,0.833478260869558,1.94478260869563
1515,"Herøy (Møre og Romsdal)",8390,8765,8824,8518,375,59,-247,2.71250217391304,2.75104565217391,2.77206936758893,2.80010098814229,0.0385434782608698,0.0210237154150201,0.0490553359683799
5029,"Skaun",5843,8360,9065,9947,2517,705,1587,1.51452391304348,1.7297804347826,1.84719308300395,2.00374328063241,0.21525652173912,0.11741264822135,0.27396284584981
1840,"Saltdal",4887,4617,5039,4749,-270,422,132,4.19251304347826,4.39849565217391,4.51084980237154,4.66065533596838,0.20598260869565,0.11235415019763,0.26215968379447
3220,"Enebakk",8680,11249,12207,13266,2569,958,2017,2.07039130434779,3.70541739130434,4.59724980237154,5.78635968379447,1.63502608695655,0.8918324110672,2.08094229249013
4212,"Vegårshei",1838,2131,2584,2680,293,453,549,0.275752173913034,0.657039130434782,0.865013833992089,1.14231343873517,0.381286956521748,0.207974703557307,0.485274308300388
3405,"Lillehammer",24724,28425,30668,32314,3701,2243,3889,6.86287173913043,7.04345869565217,7.14196067193676,7.27329664031621,0.18058695652174,0.0985019762845898,0.22983794466404
3230,"Gjerdrum",4554,6989,8303,9468,2435,1314,2479,1.22822608695651,1.99643478260869,2.41545770750988,2.97415494071147,0.76820869565218,0.41902292490119,0.97772015810278
3236,"Jevnaker",5995,6908,7644,8358,913,736,1450,1.42292934782608,1.98846195652174,2.29693428853754,2.70823073122529,0.56553260869566,0.3084723320158,0.71976877470355
5607,"Vadsø",6130,5568,5860,5573,-562,292,5,1.52636086956522,1.67599565217391,1.75761462450593,1.86643992094862,0.14963478260869,0.08161897233202,0.19044426877471
3436,"Nord-Fron",5953,5628,5325,5033,-325,-303,-595,1.73823260869563,2.65087173913042,3.14867490118577,3.81241245059289,0.91263913043479,0.49780316205535,1.16154071146247
1573,"Smøla",2432,2120,2202,2162,-312,82,42,0.942436956521735,1.17522391304347,1.30219861660079,1.47149822134387,0.232786956521735,0.12697470355732,0.2962743083004
1535,"Vestnes",6530,6936,7220,7079,406,284,143,1.80768913043478,1.91698043478261,1.97659387351779,2.05607845849802,0.10929130434783,0.0596134387351799,0.13909802371541
1539,"Rauma",7415,7019,7503,7290,-396,484,271,6.74793586956524,6.56525543478261,6.46561156126482,6.33275306324111,-0.18268043478263,-0.09964387351779,-0.2325023715415
5020,"Osen",1194,904,899,867,-290,-5,-37,0.387586956521738,0.446047826086956,0.47793557312253,0.520452569169961,0.058460869565218,0.031887747035574,0.074404743083005
1822,"Leirfjord",2242,2257,2515,2550,15,258,293,0.19176847826087,0.183570652173913,0.179099110671937,0.173137055335968,-0.00819782608695702,-0.00447154150197598,-0.010433596837945
1834,"Lurøy",2107,1869,1935,1940,-238,66,71,0.135821739130433,0.220108695652173,0.266083399209485,0.327383003952567,0.08428695652174,0.045974703557312,0.107274308300394
4001,"Porsgrunn",32892,36624,38808,40193,3732,2184,3569,12.6007728260869,16.0635228260869,17.9522955533597,20.4706591897233,3.46275,1.8887727272728,4.4071363636364
5059,"Orkland",17920,18502,19034,19459,582,532,957,6.48808043478261,7.04979782608695,7.35618913043479,7.76471086956522,0.56171739130434,0.30639130434784,0.71491304347827
5006,"Steinkjer",23192,24004,23600,23004,812,-404,-1000,4.03370217391303,5.04283695652173,5.59327411067194,6.32719031620553,1.0091347826087,0.55043715415021,1.2843533596838
5501,"Tromsø",59145,77544,82471,85028,18399,4927,7484,22.3208021739131,23.5765369565217,24.261483201581,25.1747448616601,1.2557347826086,0.684946245059301,1.5982079051384
3905,"Tønsberg",42652,57794,62854,66892,15142,5060,9098,23.3688326086955,28.6884195652173,31.5900124505928,35.4588029644269,5.3195869565218,2.9015928853755,6.7703833992096
3446,"Gran",12877,13633,13638,13973,756,5,340,2.68098260869561,4.1508,4.95251857707509,6.02147667984189,1.46981739130439,0.80171857707509,1.87067667984189
3435,"Vågå",3818,3591,3324,3063,-227,-267,-528,4.20316630434782,5.26984239130431,5.85166571146246,6.62743013833993,1.06667608695649,0.58182332015815,1.35758774703562
4637,"Hyllestad",1554,1290,1284,1294,-264,-6,4,0.586056521739131,0.575804347826086,0.570212252964427,0.562756126482213,-0.010252173913045,-0.00559209486165901,-0.0130482213438731
5605,"Sør-Varanger",9532,9925,10443,10397,393,518,472,6.72635543478259,7.63130543478259,8.1249145256917,8.78305998023715,0.904949999999999,0.493609090909111,1.15175454545456
4216,"Birkenes",4290,5342,5863,6251,1052,521,909,1.58448913043476,2.57084999999999,3.10886501976285,3.82621837944665,0.98636086956523,0.53801501976286,1.25536837944666
1812,"Sømna",2116,1981,1948,1891,-135,-33,-90,0.144029347826087,0.178248913043478,0.196914130434783,0.221801086956522,0.034219565217391,0.018665217391305,0.043552173913044
5042,"Lierne",1565,1309,1226,1109,-256,-83,-200,0.384114130434785,0.290885869565217,0.240034090909091,0.17223171936759,-0.093228260869568,-0.050851778656126,-0.118654150197627
4205,"Lindesnes",19909,23147,24206,24610,3238,1059,1463,12.58245,15.7489239130435,17.4760915019763,19.7789816205533,3.1664739130435,1.7271675889328,4.0300577075098
4012,"Bamble",14142,14056,14346,14244,-86,290,188,5.69542499999989,9.13101847826084,11.0049785573123,13.5035919960475,3.43559347826095,1.87396007905146,4.37257351778666
5528,"Dyrøy",1337,1068,1051,1011,-269,-17,-57,0.245465217391305,0.251726086956521,0.255141106719368,0.259694466403162,0.00626086956521599,0.00341501976284703,0.00796837944664103
301,"Oslo",507467,699827,769345,817225,192360,69518,117398,73.182179347826,79.3232902173913,82.672987055336,87.1392495059288,6.14111086956531,3.34969683794469,7.8159592885375
1516,"Ulstein",6541,8557,9352,9708,2016,795,1151,2.14952282608694,2.48547717391304,2.668725,2.91305543478261,0.3359543478261,0.18324782608696,0.42757826086957
3448,"Nordre Land",6950,6577,6322,6187,-373,-255,-390,1.59985760869565,1.52118586956522,1.47827401185771,1.42105820158103,-0.0786717391304299,-0.04291185770751,-0.10012766798419
4207,"Flekkefjord",8851,9048,9192,9076,197,144,28,3.30482934782608,3.83639673913043,4.12634258893281,4.51293705533597,0.53156739130435,0.28994584980238,0.67654031620554
4649,"Stad",8846,9527,9657,9579,681,130,52,2.63891739130435,2.28979565217391,2.09936561264822,1.84545889328063,-0.34912173913044,-0.19043003952569,-0.44433675889328
5037,"Levanger - Levangke",17501,20171,21262,21670,2670,1091,1499,4.80889565217391,5.2888695652174,5.55067351778656,5.89974545454545,0.47997391304349,0.26180395256916,0.61087588932805
1839,"Beiarn",1311,1012,1087,1018,-299,75,6,0.734576086956537,0.202910869565216,0,0,-0.531665217391321,-0.202910869565216,-0.202910869565216
5038,"Verdal",13644,14955,15257,14986,1311,302,31,3.8031358695652,4.33403804347826,4.62362104743083,5.00973171936759,0.53090217391306,0.28958300395257,0.67569367588933
3452,"Vestre Slidre",2282,2111,2165,2177,-171,54,66,0.504733695652173,0.597570652173913,0.648208992094862,0.715726778656127,0.0928369565217401,0.050638339920949,0.118156126482214
5033,"Tydal",949,750,802,791,-199,52,41,0.377775000000002,0.334946739130435,0.311585869565217,0.28043804347826,-0.042828260869567,-0.023360869565218,-0.054508695652175
1868,"Øksnes",4758,4458,4597,4457,-300,139,-1,0.489599999999994,0.657156521739127,0.748550988142293,0.870410276679845,0.167556521739133,0.0913944664031661,0.213253754940718
3118,"Indre Østfold",36944,45608,50311,54053,8664,4703,8445,15.775708695652,22.8108913043478,26.6482636363637,31.7647600790514,7.0351826086958,3.8373723320159,8.9538687747036
5546,"Kvænangen",1435,1159,1247,1245,-276,88,86,0.67919673913044,0.49502934782609,0.394574407114623,0.260634486166006,-0.18416739130435,-0.100454940711467,-0.234394861660084
3433,"Skjåk",2386,2151,1968,1767,-235,-183,-384,8.74237500000004,7.97759021739128,7.56043488142292,7.00422776679842,-0.76478478260876,-0.41715533596836,-0.973362450592861
3453,"Øystre Slidre",3060,3252,3400,3396,192,148,144,1.07672282608695,1.319625,1.45211709486166,1.62877322134387,0.24290217391305,0.13249209486166,0.30914822134387
5022,"Rennebu",2700,2443,2445,2396,-257,2,-47,0.605915217391303,0.708241304347824,0.764055533596838,0.838474505928853,0.102326086956521,0.055814229249014,0.130233201581029
4619,"Eidfjord",1037,937,1002,987,-100,65,50,1.7903054347826,2.3554858695652,2.66376610671936,3.0748064229249,0.5651804347826,0.30828023715416,0.7193205533597
3418,"Åsnes",8112,7211,7406,7282,-901,195,71,1.69971847826086,2.11393369565218,2.3398692687747,2.64111669960474,0.41421521739132,0.22593557312252,0.52718300395256
4016,"Drangedal",4175,4093,3935,3824,-82,-158,-269,0.881951086956491,1.77359673913043,2.25994891304347,2.90841847826087,0.891645652173939,0.48635217391304,1.13482173913044
3238,"Nannestad",8967,15074,19362,22404,6107,4288,7330,2.60279021739126,3.80074891304346,4.45418092885375,5.32542361660079,1.1979586956522,0.65343201581029,1.52467470355733
1111,"Sokndal",3358,3281,3182,2993,-77,-99,-288,3.77317173913033,6.51961956521734,8.01768201581025,10.0150986166008,2.74644782608701,1.49806245059291,3.49547905138346
3332,"Sigdal",3556,3492,3565,3582,-64,73,90,1.20922826086956,1.39255434782608,1.49255039525692,1.62587845849802,0.18332608695652,0.0999960474308399,0.23332411067194
4624,"Bjørnafjorden",17580,25213,28049,30340,7633,2836,5127,6.17376521739129,8.09976521739128,9.15031067193677,10.551037944664,1.92599999999999,1.05054545454549,2.45127272727272
3413,"Stange",17928,21156,23143,24529,3228,1987,3373,4.29080869565212,7.61243478260872,9.42423083003957,11.8399588932807,3.3216260869566,1.81179604743085,4.22752411067198
1857,"Værøy",775,678,661,650,-97,-17,-28,0.106972826086956,0.137827173913043,0.154656818181818,0.177096343873518,0.030854347826087,0.016829644268775,0.039269169960475
1827,"Dønna",1582,1369,1437,1378,-213,68,9,0.0461152173913035,0.0747195652173911,0.0903219367588933,0.111125098814229,0.0286043478260876,0.0156023715415022,0.0364055335968379
1151,"Utsira",256,188,272,305,-68,84,117,0,0,0,0,0,0,0
1145,"Bokn",786,855,914,920,69,59,65,0.581468478260867,0.721653260869564,0.798117687747034,0.900070256916995,0.140184782608697,0.0764644268774699,0.178416996047431
1103,"Stavanger",114794,144699,156281,161063,29905,11582,16364,30.449054347826,33.5276413043478,35.2068705533597,37.4458428853755,3.0785869565218,1.6792292490119,3.9182015810277
5632,"Båtsfjord",2470,2165,2111,2076,-305,-54,-89,0.637336956521738,0.638315217391304,0.638848814229249,0.639560276679842,0.000978260869565983,0.000533596837944961,0.00124505928853802
4638,"Høyanger",4677,3965,3601,3325,-712,-364,-640,1.88779891304349,1.47217500000001,1.24547104743083,0.943199110671934,-0.41562391304348,-0.22670395256918,-0.528975889328076
5041,"Snåase - Snåsa",2397,2033,2138,1996,-364,105,-37,0.361398913043478,0.294583695652174,0.258139031620554,0.209546146245059,-0.066815217391304,-0.03644466403162,-0.085037549407115
5626,"Gamvik",1288,1057,1245,1366,-231,188,309,0.401761956521742,0.307751086956523,0.256472430830039,0.188100889328063,-0.094010869565219,-0.051278656126484,-0.11965019762846
4615,"Fitjar",2992,3117,3217,3193,125,100,76,1.06057173913042,1.93995,2.41961086956522,3.05915869565218,0.87937826086958,0.47966086956522,1.11920869565218
3429,"Folldal",1814,1530,1490,1445,-284,-40,-85,1.68700108695653,1.59932934782609,1.55150839920949,1.48774713438735,-0.08767173913044,-0.0478209486165999,-0.11158221343874
4635,"Gulen",2489,2230,2285,2304,-259,55,74,1.86881086956518,3.44705869565215,4.30792114624508,5.45573774703557,1.57824782608697,0.860862450592931,2.00867905138342
3326,"Hemsedal",1958,2611,3086,3475,653,475,864,1.50211956521738,1.88446304347826,2.09301403162056,2.37108201581028,0.38234347826088,0.2085509881423,0.48661897233202
1856,"Røst",666,469,451,429,-197,-18,-40,0.142219565217391,0.179667391304347,0.200093478260869,0.227328260869565,0.037447826086956,0.020426086956522,0.047660869565218
1149,"Karmøy",36971,42541,43549,43353,5570,1008,812,14.0637228260869,18.2883032608696,20.5926198616601,23.6650419960474,4.2245804347827,2.3043166007905,5.3767387351778
3907,"Sandefjord",53552,64943,69566,73640,11391,4623,8697,21.2032663043477,28.3540206521739,32.2544321146246,37.4549807312253,7.1507543478262,3.9004114624507,9.1009600790514
4228,"Sirdal",1734,1810,1923,1912,76,113,102,0.738215217391286,1.52078478260869,1.94764090909091,2.51678241106718,0.782569565217404,0.42685612648222,0.99599762845849
1112,"Lund",3096,3178,3240,3224,82,62,46,0.951857608695647,1.3598902173913,1.58245345849803,1.87920444664032,0.408032608695653,0.22256324110673,0.51931422924902
5520,"Bardu",3889,3993,4352,4448,104,359,455,4.25534673913043,4.50525326086956,4.64156590909091,4.82331610671937,0.24990652173913,0.13631264822135,0.31806284584981
5014,"Frøya",4115,5265,6267,6980,1150,1002,1715,8.44467065217387,10.2880858695652,11.2935850790514,12.6342506916996,1.84341521739133,1.0054992094862,2.3461648221344
1811,"Bindal",1921,1406,1327,1209,-515,-79,-197,0.435991304347827,0.422608695652173,0.415309090909091,0.40557628458498,-0.013382608695654,-0.007299604743082,-0.017032411067193
1554,"Averøy",5409,5828,6249,6417,419,421,589,1.40885217391303,1.95777391304348,2.25718577075099,2.65640158102767,0.54892173913045,0.29941185770751,0.69862766798419
4217,"Åmli",1862,1801,1882,1942,-61,81,141,0.675342391304341,1.06439673913043,1.27660820158102,1.55955681818182,0.389054347826089,0.21221146245059,0.49516007905139
1101,"Eigersund",13288,14860,15196,14857,1572,336,-3,8.718427173913,10.5063554347826,11.4815890316206,12.7819004940712,1.7879282608696,0.975233596838001,2.2755450592886
4032,"Fyresdal",1353,1198,1297,1313,-155,99,115,0.758161956521736,1.04277717391304,1.19802183794466,1.40501472332016,0.284615217391304,0.15524466403162,0.36223754940712
4203,"Arendal",39446,45509,47432,48284,6063,1923,2775,12.0070271739129,17.6834249999999,20.7796419960474,24.9079313241108,5.676397826087,3.0962169960475,7.2245063241109
3112,"Råde",6217,7633,8645,9594,1416,1012,1961,5.20212717391297,7.11887282608691,8.16437045454546,9.55836729249013,1.91674565217394,1.04549762845855,2.43949446640322
5044,"Namsskogan",989,818,880,920,-171,62,102,0.642091304347833,0.44925652173913,0.344073913043479,0.203830434782611,-0.192834782608703,-0.105182608695651,-0.245426086956519
4616,"Tysnes",2843,2883,2966,2993,40,83,110,0.683334782608686,0.928682608695645,1.06250869565217,1.24094347826087,0.245347826086959,0.133826086956525,0.312260869565225
3421,"Trysil",7069,6603,6273,6094,-466,-330,-509,2.18737173913043,2.48621086956521,2.64921403162055,2.86655158102767,0.29883913043478,0.16300316205534,0.38034071146246
3440,"Øyer",4859,5082,5273,5436,223,191,354,1.80251413043477,2.30140760869565,2.57353132411067,2.93636294466403,0.49889347826088,0.27212371541502,0.63495533596838
5510,"Kvæfjord",3287,2789,3116,3156,-498,327,367,0.590292391304348,0.647481521739128,0.678675592885375,0.720267687747035,0.05718913043478,0.0311940711462471,0.072786166007907
5032,"Selbu",3926,4090,4338,4481,164,248,391,0.883848913043476,1.10209891304347,1.22114436758893,1.37987164031621,0.218249999999994,0.11904545454546,0.27777272727274
3110,"Hvaler",3494,4741,5443,6101,1247,702,1360,7.91032499999996,9.34885760869564,10.1335117588933,11.1797172924901,1.43853260869568,0.78465415019766,1.83085968379446
4634,"Masfjorden",1774,1629,1766,1765,-145,137,136,0.774176086956521,0.922363043478262,1.00319229249012,1.11096462450593,0.148186956521741,0.080829249011858,0.188601581027668
3441,"Gausdal",6186,6079,6092,6021,-107,13,-58,1.10608043478261,1.24980652173913,1.32820256916996,1.43273063241107,0.14372608695652,0.0783960474308298,0.18292411067194
3312,"Lier",21308,27584,31159,34197,6276,3575,6613,9.96909456521735,11.6456184782608,12.5600860671937,13.7793761857708,1.67652391304345,0.914467588932899,2.13375770751
3316,"Modum",12366,14273,15419,16382,1907,1146,2109,4.35178369565216,6.01504239130435,6.92227440711461,8.13191709486165,1.66325869565219,0.90723201581026,2.1168747035573
4213,"Tvedestrand",5967,6115,6788,7077,148,673,962,1.87645108695648,3.37931413043475,4.19905760869561,5.29204891304345,1.50286304347827,0.81974347826086,1.9127347826087
5536,"Lyngen",3225,2729,2661,2499,-496,-68,-230,2.65647717391305,2.16220108695651,1.8925959486166,1.53312243083004,-0.49427608695654,-0.26960513833991,-0.62907865612647
1833,"Rana - Raane",25255,26092,25077,24114,837,-1015,-1978,5.08649673913042,5.51519021739129,5.74902302371541,6.06080009881423,0.42869347826087,0.23383280632412,0.54560988142294
4626,"Øygarden",26961,39032,42088,44821,12071,3056,5789,16.4157065217391,19.3877804347826,21.0089116600791,23.1704199604743,2.9720739130435,1.6211312252965,3.7826395256917
5522,"Salangen",2346,2087,2026,1977,-259,-61,-110,0.647755434782607,0.73628804347826,0.784578557312253,0.848965909090909,0.088532608695653,0.048290513833993,0.112677865612649
3314,"Øvre Eiker",15058,20044,23104,25722,4986,3060,5678,6.28867173913039,8.86231956521738,10.2661274703558,12.1378713438735,2.57364782608699,1.40380790513842,3.27555177865612
1511,"Vanylven",3584,3045,2871,2585,-539,-174,-460,1.17538043478261,1.13167173913043,1.10783063241107,1.07604249011858,-0.0437086956521799,-0.02384110671936,-0.05562924901185
5026,"Holtålen",2239,1953,2007,1952,-286,54,-1,0.478232608695652,0.373167391304346,0.315859090909091,0.239448023715415,-0.105065217391306,-0.057308300395255,-0.133719367588931
3432,"Lesja",2303,1986,1836,1707,-317,-150,-279,8.01156521739132,8.0419304347826,8.05849328063241,8.08057707509881,0.0303652173912798,0.0165628458498102,0.0386466403162107
3338,"Nore og Uvdal",2764,2455,2431,2370,-309,-24,-85,0.776611956521739,0.813179347826086,0.833125197628458,0.85971966403162,0.0365673913043471,0.019945849802372,0.046540316205534
1517,"Hareid",4748,5126,5608,5629,378,482,503,1.15242065217391,1.20268369565217,1.23009990118577,1.26665484189723,0.05026304347826,0.0274162055336,0.0639711462450601
5054,"Indre Fosen",10015,9899,9781,9501,-116,-118,-398,3.1137554347826,3.55360108695652,3.7935168972332,4.11340464426877,0.43984565217392,0.23991581027668,0.55980355731225
4224,"Åseral",878,912,890,832,34,-22,-80,0.557833695652171,0.929827173913047,1.13273270750988,1.40327341897234,0.371993478260876,0.202905533596833,0.473446245059293
1837,"Meløy",6796,6214,5818,5407,-582,-396,-807,1.02336847826087,1.36554456521738,1.55218606719368,1.80104140316206,0.34217608695651,0.1866415019763,0.43549683794468
5027,"Midtre Gauldal",5779,6120,6079,5986,341,-41,-134,1.50222717391304,1.730025,1.85427835968379,2.01994950592885,0.22779782608696,0.12425335968379,0.28992450592885
5046,"Høylandet",1335,1193,1156,1054,-142,-37,-139,0.317788043478261,0.274646739130434,0.251115118577076,0.21973962450593,-0.043141304347827,-0.023531620553358,-0.054907114624504
3203,"Asker",73892,96088,104860,112954,22196,8772,16866,19.5000163043476,25.1167402173912,28.1804078063241,32.2652979249012,5.6167239130436,3.0636675889329,7.14855770751
4633,"Fedje",682,502,596,605,-180,94,103,0.504459782608697,0.473096739130436,0.455989624505929,0.433180138339921,-0.031363043478261,-0.017107114624507,-0.039916600790515
4644,"Luster",5003,5246,5319,5118,243,73,-128,10.4037945652174,10.6786663043478,10.8285963438735,11.0285030632411,0.274871739130401,0.149930039525699,0.3498367588933
4018,"Nome",6648,6494,6592,6588,-154,98,94,1.77128804347825,2.27213804347826,2.54532895256917,2.90958349802372,0.50085000000001,0.27319090909091,0.63744545454546
5624,"Lebesby",1463,1221,1255,1308,-242,34,87,2.01435652173913,1.94016521739131,1.89969723320158,1.84573992094862,-0.07419130434782,-0.04046798418973,-0.0944252964426899
5542,"Skjervøy",2934,2804,2804,2711,-130,0,-93,0.567958695652176,0.502258695652174,0.46642233201581,0.418640513833992,-0.0657000000000021,-0.0358363636363639,-0.083618181818182
1871,"Andøy",5744,4572,4476,4301,-1172,-96,-271,2.14453369565218,2.12436195652174,2.11335918972332,2.0986888339921,-0.0201717391304399,-0.0110027667984198,-0.02567312252964
3209,"Ullensaker",20160,41565,50505,57478,21405,8940,15913,16.2621097826085,21.5590989130434,24.4483657114625,28.3007214426878,5.2969891304349,2.8892667984191,6.7416225296444
1160,"Vindafjord",8135,8775,8989,8972,640,214,197,3.32144999999998,4.46284565217391,5.08542509881424,5.91553102766799,1.14139565217393,0.62257944664033,1.45268537549408
5031,"Malvik",11132,14425,16122,17357,3293,1697,2932,3.39548478260869,3.70747173913043,3.87764644268775,4.10454604743083,0.31198695652174,0.17017470355732,0.3970743083004
1870,"Sortland - Suortá",9230,10468,10692,10529,1238,224,61,1.66819891304348,1.8947054347826,2.01825444664032,2.18298646245059,0.22650652173912,0.12354901185772,0.28828102766799
5628,"Deatnu - Tana",3074,2821,2848,2838,-253,27,17,4.80259565217392,4.70187391304348,4.64693478260869,4.57368260869565,-0.10072173913044,-0.0549391304347902,-0.12819130434783
3443,"Vestre Toten",13065,13572,14242,14816,507,670,1244,2.90560108695652,3.19146847826086,3.34739614624506,3.55529970355731,0.28586739130434,0.1559276679842,0.36383122529645
4614,"Stord",16144,18919,19496,19505,2775,577,586,4.92870326086953,6.20500108695649,6.90116353754941,7.8293801383399,1.27629782608696,0.69616245059292,1.62437905138341
1557,"Gjemnes",2683,2669,2849,2946,-14,180,277,0.573740217391305,0.539598913043478,0.52097638339921,0.496146343873518,-0.034141304347827,-0.0186225296442679,-0.0434525691699599
3423,"Stor-Elvdal",3012,2318,2398,2500,-694,80,182,1.96130543478261,1.82605108695652,1.75227598814229,1.65390918972332,-0.13525434782609,-0.0737750988142301,-0.1721418972332
3107,"Fredrikstad",67761,83892,89730,95318,16131,5838,11426,30.3088597826086,37.1886358695651,40.9412410079051,45.9447145256917,6.8797760869565,3.75260513834,8.7560786561266
4204,"Kristiansand",86779,113737,127794,139635,26958,14057,25898,30.9696945652173,39.3291489130435,43.888851284585,49.9684544466403,8.3594543478262,4.5597023715415,10.6393055335968
5538,"Storfjord - Omasvuotna - Omasvuono",1872,1836,1785,1745,-36,-51,-91,1.66249565217391,1.74983478260869,1.7974743083004,1.86099367588933,0.0873391304347799,0.0476395256917099,0.11115889328064
3442,"Østre Toten",14103,14827,14826,15071,724,-1,244,2.79404021739129,3.27313369565216,3.53445741106719,3.88288903162055,0.47909347826087,0.26132371541503,0.60975533596839
1875,"Hábmer - Hamarøy",2721,2708,2849,2851,-13,141,143,8.07420326086957,8.31816195652173,8.45123033596838,8.62865484189723,0.243958695652159,0.13306837944665,0.310492885375501
5503,"Harstad - Hárstták",23627,24804,24925,24318,1177,121,-486,4.07248043478261,4.44269347826087,4.64462786561264,4.91387371541502,0.370213043478261,0.20193438735177,0.47118023715415
5540,"Gáivuotna - Kåfjord - Kaivuono",2369,2012,1841,1758,-357,-171,-254,0.720058695652178,0.620941304347825,0.566877272727274,0.494791897233202,-0.0991173913043529,-0.0540640316205511,-0.126149407114623
4648,"Bremanger",4170,3521,3056,2771,-649,-465,-750,4.1082652173913,4.46325652173913,4.65688814229249,4.91506363636363,0.35499130434783,0.193631620553361,0.451807114624501
3232,"Nittedal",18639,24947,28270,30903,6308,3323,5956,3.57886956521733,4.97653043478256,5.7388909090909,6.75537154150196,1.39766086956523,0.76236047430834,1.7788411067194
4620,"Ulvik",1222,1051,1204,1215,-171,153,164,3.57684456521739,4.15039891304346,4.46324673913044,4.88037717391305,0.57355434782607,0.31284782608698,0.72997826086959
5043,"Raarvihke - Røyrvik",595,441,406,383,-154,-35,-58,0.242481521739132,0.187875,0.158089624505929,0.118375790513834,-0.054606521739132,-0.029785375494071,-0.069499209486166
1826,"Aarborte - Hattfjelldal",1634,1273,1230,1140,-361,-43,-133,0.706754347826099,0.267045652173913,0.0272045454545449,0,-0.439708695652186,-0.239841106719368,-0.267045652173913
5603,"Hammerfest - Hámmerfeasta",10319,11274,11340,11125,955,66,-149,2.27151195652173,2.68185326086956,2.90567579051383,3.20410583003953,0.41034130434783,0.22382252964427,0.52225256916997
5512,"Dielddanuorri - Tjeldsund",4636,4201,4493,4448,-435,292,247,1.61082391304347,2.10461086956521,2.37394920948616,2.73306699604742,0.49378695652174,0.26933833992095,0.62845612648221
5622,"Porsanger - Porsángu - Porsanki",4451,3904,3785,3617,-547,-119,-287,3.70246304347826,3.93407608695652,4.0604104743083,4.22885632411067,0.23161304347826,0.12633438735178,0.29478023715415
5636,"Unjárga - Nesseby",965,854,927,944,-111,73,90,0.503765217391308,0.360626086956522,0.282550197628458,0.178449011857707,-0.143139130434786,-0.078075889328064,-0.182177075098815
